{
  "Id":"10-trade-tunnel",
  "Name":"Trade Tunnel",
  "Music":"kawarayu",
  "Width":16,
  "Height":16,
  "BackgroundImage":2,
  "Tiles":
  [
    [ 2, 2, 3, 2, 2, 2, 2, 2, 2, 0, 0, 0, 0, 0, 0, 0],
    [ 2, 5, 5, 5, 2, 5, 5, 5, 2, 0, 2, 2, 2, 2, 2, 0],
    [ 2, 5, 5, 5,16, 5,15, 5, 2, 0, 2, 8, 2, 8, 2, 0],
    [ 2, 5, 5, 5, 2, 5,15, 5, 2, 2, 2,18, 2,18, 2, 0],
    [ 2, 2,16, 2, 2, 5, 9, 5, 5, 5, 5, 5, 5, 5, 2, 0],
    [ 2, 5, 5, 5, 2, 5,15, 5, 2, 2, 2, 2, 2, 2, 2, 0],
    [ 2, 5, 5, 5, 2, 5,15, 5, 2, 0, 0, 0, 0, 0, 0, 0],
    [ 2, 5, 5, 5, 2, 5, 1, 5, 2, 0, 0, 2, 2, 3, 2, 2],
    [ 2, 7, 5, 5, 2, 5,15, 5, 2, 0, 0, 2, 5, 5, 5, 2],
    [ 2, 5, 5, 5, 2, 5,15, 5, 2, 0, 0, 3, 5, 5, 8, 2],
    [ 2, 5, 5, 5, 5, 5, 1, 5, 2, 0, 0, 2, 5, 5, 5, 2],
    [ 2, 5, 5, 5, 2, 5,15, 5, 2, 2, 2, 2, 2, 5, 2, 2],
    [ 2, 2, 5, 2, 2, 5,15, 5, 5, 5, 5, 5, 5, 5, 5, 2],
    [ 2, 7, 5, 7, 2, 5,15,15, 1,15,15, 1,15,15, 5, 2],
    [ 2, 2, 5, 2, 2, 5, 5, 5, 5, 5, 5, 5, 5, 5, 5, 2],
    [ 2, 2, 3, 2, 2, 2, 2, 2, 2, 2, 2, 2, 2, 2, 2, 2]
  ],
  "Portals":
  [
    {"X":2,"Y":0,"Destination":"6-zuruth-plains","DestX":8,"DestY":14}
  ],
  "Stores":
  [
    {"X":2,"Y":15,"Store":"5-stonegate-entrance","DestX":2,"DestY":14},
    {"X":11,"Y":9,"Store":"6-thomas-the-fence","DestX":12,"DestY":9},
    {"X":13,"Y":7,"Store":"7-thieves-guild","DestX":13,"DestY":8}
  ],
  "Enemies":
  [
    "ENEMY_ZOMBIE",
    "ENEMY_SKELETON",
    "ENEMY_DRUID"
  ]
}