{
  "Id":"4-monastery-trail",
  "Name":"Monastery Trail",
  "Music":"m31",
  "Width":14,
  "Height":16,
  "BackgroundImage":1,
  "Tiles":
  [
    [0,12,12,2,0,0,0,0,0,2,12,0,0,0],
    [12,12,12,2,2,2,3,2,2,2,12,0,0,0],
    [12,12,9,6,12,6,1,6,6,12,12,12,0,0],
    [12,12,12,6,6,6,1,12,6,6,12,12,0,0],
    [0,12,12,12,12,6,1,6,6,12,12,12,0,0],
    [0,0,12,12,12,12,6,6,12,12,12,12,0,0],
    [0,0,0,12,12,6,6,6,6,12,12,12,12,0],
    [0,0,12,12,12,6,6,12,6,6,6,12,12,0],
    [0,12,12,12,6,6,12,12,12,6,12,12,12,0],
    [0,12,12,6,6,6,12,12,6,6,6,12,12,0],
    [0,12,12,12,6,6,6,6,6,6,12,12,12,0],
    [0,0,12,12,6,6,6,12,6,6,6,12,12,12],
    [0,0,12,12,12,6,12,12,12,6,1,6,12,12],
    [0,0,0,12,10,11,12,12,12,12,1,6,12,12],
    [0,0,0,0,12,12,12,12,12,6,1,6,12,12],
    [0,0,0,0,0,0,0,12,12,2,3,2,12,12]
  ],
  "Portals":
  [
    {"X":6,"Y":1,"Destination":"1-monastery","DestX":4,"DestY":9},
    {"X":10,"Y":15,"Destination":"5-cedar-village","DestX":3,"DestY":1}
  ],
  "Shops":
  [
    {"X":5,"Y":13,"ShopId":"4-woodsman","DestX":5,"DestY":12}
  ],
  "Enemies":
  [
    "ENEMY_SHADOW_TENDRILS",
    "ENEMY_IMP",
    "ENEMY_SHADOW_SOUL"
  ]
}