{
  "Id":"6-zuruth-plains",
  "Name":"Zuruth Plains",
  "Music":"m31",
  "Width":16,
  "Height":16,
  "BackgroundImage":"back_2",
  "Tiles":
  [
    [ 0, 0, 0, 0, 0, 0, 2,12,12,12,12,12,12,15,15,15],
    [ 0, 0, 0, 0, 0, 0, 2,12,12,12,12,12,12,15,15,15],
    [ 2, 2, 2, 2, 3, 2, 2, 6, 6, 6, 6, 6, 6,15,15,15],
    [12,12,12, 6, 1, 6, 6, 6, 7, 5, 7, 6, 6,15,15,15],
    [12,12, 6, 6, 1, 6,12, 6, 5, 8, 5, 6, 6,15,15,15],
    [12,12, 6,12, 1, 6, 6, 6, 7, 5, 7, 6, 6,15,15,15],
    [12,12, 6, 6, 1, 6, 6, 6, 6, 6, 6, 6, 4,15,15,15],
    [12,12, 6, 6, 1, 1, 1, 1, 1, 1, 1, 1, 1, 1, 1, 1],
    [12,12,12, 6, 6, 6, 6, 6, 1, 6, 6, 6, 4,15,15,15],
    [12,12, 6, 6, 6, 6,12, 6, 1, 6,12, 6, 6,15,15,15],
    [12,12, 6, 6, 6,12, 6, 6, 1, 6, 6, 6, 6,15,15,15],
    [12,12,12, 6, 6, 6, 6,12, 1, 6, 6, 6,12,15,15,15],
    [12,12, 6, 6, 6, 6, 6, 6, 1, 6, 6, 6, 6,15,15,15],
    [12, 7, 5, 7, 5, 7, 5, 7, 5, 7, 5, 7, 6, 4,15, 4],  
    [12, 2, 5, 5, 5, 2, 5, 5, 5, 5, 5, 2, 6,15, 9,15],
    [ 2, 2, 2, 2, 2, 2, 2, 2, 3, 2, 2, 2, 2, 2, 2, 2]
  ],
  "Portals":
  [
    {"X":4,"Y":2,"Destination":"5-cedar-village","DestX":9,"DestY":10},
    {"X":14,"Y":7,"Destination":"7-canal-boneyard","DestX":2,"DestY":5},
    {"X":8,"Y":15,"Destination":"10-trade-tunnel","DestX":2,"DestY":1}
  ],
  "Enemies":
  [
    "ENEMY_IMP",
    "ENEMY_SHADOW_SOUL",
    "ENEMY_ZOMBIE"
  ]
}