{
  "Id":"7-canal-boneyard",
  "Name":"Canal Boneyard",
  "Music":"m31",
  "Width":15,
  "Height":11,
  "BackgroundImage":2,
  "Tiles":
  [
    [ 0,15,15,15, 2, 2, 2, 2, 2, 2, 2, 2, 2, 2, 2],
    [ 0,15,15,15,12, 6, 6, 6, 6, 6,14,14,13,14, 2],
    [ 0,15,15,15,13, 6,14, 1,14, 6,13,13,14,13, 2],
    [ 6,15,15,15, 6, 6,14, 1,13, 6, 6, 6, 6, 6, 2],
    [ 4,15,15,15, 4, 6,13, 1,14, 6, 2, 2, 2, 5, 2],
    [ 1, 1, 1, 1, 1, 1, 1, 1, 1, 1, 3, 2, 2, 8, 2],
    [ 4,15,15,15, 4, 6,14, 1,13, 6, 2, 2, 2, 5, 2],
    [ 6,15,15,15, 6, 6,13, 1,14, 6, 6, 6, 6, 6, 2],
    [ 0,15,15,15,13, 6,14, 1,13, 6,14,13,13,14, 2],
    [ 0,15,15,15,12, 6, 6, 6, 6, 6,14,13,14,13, 2],
    [ 0,15,15,15, 2, 2, 2, 2, 2, 2, 2, 2, 2, 2, 2]
  ],
  "Portals":
  [
    {"X":1,"Y":5,"Destination":"6-zuruth-plains","DestX":13,"DestY":7},
    {"X":10,"Y":5,"Destination":"8-mausoleum","DestX":1,"DestY":7}
  ],
  "Enemies":
  [
    "ENEMY_SHADOW_SOUL",
    "ENEMY_ZOMBIE",
    "ENEMY_SKELETON"
  ]
}