{
  "Id":"8-mausoleum",
  "Name":"Mausoleum",
  "Music":"elegy_dm",
  "Width":16,
  "Height":15,
  "BackgroundImage":2,
  "Tiles":
  [
    [ 0, 0, 0, 0, 2, 2, 2, 2, 2, 2, 2, 2, 2, 2, 2, 2],
    [ 0, 0, 2, 2, 2, 7, 5, 5, 5, 5, 5, 5, 7,15,15, 2],
    [ 0, 0, 2, 8,16, 5, 5, 5,15,15, 5, 5, 5, 5,15, 2],
    [ 0, 0, 2, 2, 2, 2, 2, 5, 2, 2, 5, 2, 2, 5, 2, 2],
    [ 0, 0, 0, 0, 0, 2, 2, 5, 2, 2, 5, 2, 7, 5, 2, 0],
    [ 2, 2, 2, 2, 2, 2, 5, 5, 5, 5, 5,16, 2, 5, 2, 0],
    [ 2, 5, 7, 5, 2, 2, 5, 6, 6, 6, 6, 5, 2, 5, 7, 2],
    [ 3, 5, 5, 5,16, 5, 5, 6, 6, 6, 6, 5, 5,16, 5, 3],
    [ 2, 5, 7, 5, 2, 2, 5, 6, 6, 6, 6, 5, 2, 5, 7, 2],
    [ 2, 2, 2, 2, 2, 2, 8, 5, 5, 5, 5,17, 2, 5, 2, 0],
    [ 0, 0, 0, 0, 0, 2, 2, 5, 2, 2, 5, 2, 7, 5, 2, 0],
    [ 0, 0, 2, 2, 2, 2, 2, 5, 2, 2, 5, 2, 2, 5, 2, 2],
    [ 0, 0, 2, 8,18, 5, 5, 5,15,15, 5, 5, 5, 5,15, 2],
    [ 0, 0, 2, 2, 2, 7, 5, 5, 5, 5, 5, 5, 7,15,15, 2],
    [ 0, 0, 0, 0, 2, 2, 2, 2, 2, 2, 2, 2, 2, 2, 2, 2]
  ],
  "Portals":
  [
    {"X":0,"Y":7,"Destination":"7-canal-boneyard","DestX":9,"DestY":5},
    {"X":15,"Y":7,"Destination":"9-dead-walkways","DestX":1,"DestY":5}
  ],
  "Enemies":
  [
    "ENEMY_ZOMBIE",
    "ENEMY_SKELETON",
    "ENEMY_DRUID"
  ]
}