{
  "Id":"9-dead-walkways",
  "Name":"Dead Walkways",
  "Music":"elegy_dm",
  "Width":13,
  "Height":10,
  "BackgroundImage":2,
  "Tiles":
  [
    [ 0, 0, 0, 0, 0, 0, 1, 0, 0, 1, 0, 0, 0],
    [ 0, 0, 0, 0, 0, 0, 1, 2, 2, 1, 0, 0, 0],
    [ 0, 4, 0, 0, 4, 0, 1, 5,16, 1, 0, 4, 0],
    [ 0, 0, 0, 1, 0, 0, 1, 2, 2, 1, 0, 0, 0],
    [ 2, 0, 0, 1, 2, 2, 1, 0, 0, 1,13,14,13],
    [ 3, 1, 1, 1, 5,16, 1, 0, 0, 1, 6,19,14],
    [ 2, 0, 0, 1, 2, 2, 1, 0, 0, 1,14,13,14],
    [ 0, 0, 0, 1, 0, 0, 1, 0, 0, 0, 0, 0, 0],
    [ 0, 4, 0, 0, 0, 0, 1, 0, 0, 0, 0, 4, 0],
    [ 0, 0, 0, 0, 9, 1, 1, 1, 1, 0, 0, 0, 0]
  ],
  "Portals":
  [
    {"X":0,"Y":5,"Destination":"8-mausoleum","DestX":14,"DestY":7}
  ],
  "Enemies":
  [
    "zombie",
    "skeleton",
    "druid",
    "druid"
  ]
}